NO ./path_to_the_north_texture 
SO ./path_to_the_south_texture
WE ./path_to_the_west_texture
EA ./path_to_the_east_texture
F 220,100,0
C 225,30,0

   111
111000111
1111111
      
 111111111
  1100000111
   1100000011111
     111111100001
11111111110010001
1010N0000101 1001
10000111100010001
1111111111111111
