NO ./path_to_the_north_texture 
SO ./path_to_the_south_texture

    

WE ./path_to_the_west_texture
EA ./path_to_the_east_texture
F 220,100,0
C 225,30,0

   111
111000111
1111111
1111111111
1N10000001
100001111
11111








